Neo4j Cypher 操作符统计
============================================================

Aggregation operators (aggregation-operators): 4 个操作符
----------------------------------------
  - Eager Aggregation (id: query-plan-eager-aggregation)
  - Ordered Aggregation (id: query-plan-ordered-aggregation)
  - Node Count From Count Store (id: query-plan-node-count-from-count-store)
  - Relationship Count From Count Store (id: query-plan-relationship-count-from-count-store)

Data modification operators (data-modification-operators): 21 个操作符
----------------------------------------
  - Create (id: query-plan-create)
  - Delete (id: query-plan-delete)
  - Detach Delete (id: query-plan-detach-delete)
  - Merge (id: query-plan-merge)
  - Merge IntoIntroduced in 2025.11 (id: query-plan-merge-into)
  - Merge Unique NodeIntroduced in 2025.11 (id: query-plan-merge-unique-node)
  - Locking Merge (id: query-plan-locking-merge)
  - Lock NodesIntroduced in 2025.09 (id: query-plan-lock-nodes)
  - Foreach (id: query-plan-foreach)
  - SubqueryForeach (id: query-plan-subquery-foreach)
  - TransactionForeach (id: query-plan-transaction-foreach)
  - Set Labels (id: query-plan-set-labels)
  - Remove Labels (id: query-plan-remove-labels)
  - Set Node Properties From Map (id: query-plan-set-node-properties-from-map)
  - Set Relationship Properties From Map (id: query-plan-set-relationship-properties-from-map)
  - Set Property (id: query-plan-set-property)
  - Set Properties (id: query-plan-set-properties)
  - Load CSV (id: query-plan-load-csv)
  - Eager (id: query-plan-eager)
  - Assert Same Node (id: query-plan-assert-same-node)
  - Assert Same Relationship (id: query-plan-assert-same-relationship)

Hash joins in general (execution-plans-operators-hash-join-general): 3 个操作符
----------------------------------------
  - Node Hash Join (id: query-plan-node-hash-join)
  - Value Hash Join (id: query-plan-value-hash-join)
  - Node Left/Right Outer Hash Join (id: query-plan-node-left-right-outer-hash-join)

Filter, order, and projection operators (filter-order-projection-operators): 12 个操作符
----------------------------------------
  - Empty Result (id: query-plan-empty-result)
  - Produce Results (id: query-plan-produce-results)
  - Filter (id: query-plan-filter)
  - Empty Row (id: query-plan-empty-row)
  - Cache Properties (id: query-plan-cache-properties)
  - Projection (id: query-plan-projection)
  - Project Endpoints (id: query-plan-project-endpoints)
  - Distinct (id: query-plan-distinct)
  - Ordered Distinct (id: query-plan-ordered-distinct)
  - Procedure Call (id: query-plan-procedure-call)
  - Unwind (id: query-plan-unwind)
  - Partitioned Unwind (id: query-plan-partitioned-unwind)

Leaf operators (scans and seeks) (leaf-operators): 59 个操作符
----------------------------------------
  - All Nodes Scan (id: query-plan-all-nodes-scan)
  - Partitioned All Nodes Scan (id: query-plan-partitioned-all-nodes-scan)
  - Node By Label Scan (id: query-plan-node-by-label-scan)
  - Partitioned Node By Label Scan (id: query-plan-partitioned-node-by-label-scan)
  - Intersection Node By Labels Scan (id: query-plan-intersection-node-by-labels-scan)
  - Partitioned Intersection Node By Labels Scan (id: query-plan-partitioned-intersection-node-by-labels-scan)
  - Subtraction Node By Labels Scan (id: query-plan-subtraction-node-by-labels-scan)
  - Partitioned Subtraction Node By Labels Scan (id: query-plan-partitioned-subtraction-node-by-labels-scan)
  - Union Node By Labels Scan (id: query-plan-union-node-by-labels-scan)
  - Partitioned Union Node By Labels Scan (id: query-plan-partitioned-union-node-by-labels-scan)
  - Node Index Contains Scan (id: query-plan-node-index-contains-scan)
  - Node Index Ends With Scan (id: query-plan-node-index-ends-with-scan)
  - Node Index Scan (id: query-plan-node-index-scan)
  - Partitioned Node Index Scan (id: query-plan-partitioned-node-index-scan)
  - Node By ElementId Seek (id: query-plan-node-by-elementid-seek)
  - Node By Id Seek (id: query-plan-node-by-id-seek)
  - Node Index Seek (id: query-plan-node-index-seek)
  - Partitioned Node Index Seek (id: query-plan-partitioned-node-index-seek)
  - Node Unique Index Seek (id: query-plan-node-unique-index-seek)
  - Multi Node Index Seek (id: query-plan-multi-node-index-seek)
  - Asserting Multi Node Index Seek (id: query-plan-asserting-multi-node-index-seek)
  - Node Index Seek By Range (id: query-plan-node-index-seek-by-range)
  - Partitioned Node Index Seek By Range (id: query-plan-partitioned-node-index-seek-by-range)
  - Node Unique Index Seek By Range (id: query-plan-node-unique-index-seek-by-range)
  - Directed All Relationships Scan (id: query-plan-directed-all-relationships-scan)
  - Partitioned Directed All Relationships Scan (id: query-plan-partitioned-directed-all-relationships-scan)
  - Undirected All Relationships Scan (id: query-plan-undirected-all-relationships-scan)
  - Partitioned Undirected All Relationships Scan (id: query-plan-partitioned-undirected-all-relationships-scan)
  - Directed Relationship Type Scan (id: query-plan-directed-relationship-type-scan)
  - Partitioned Directed Relationship Type Scan (id: query-plan-partitioned-directed-relationship-types-scan)
  - Undirected Relationship Type Scan (id: query-plan-undirected-relationship-type-scan)
  - Partitioned Undirected Relationship Type Scan (id: query-plan-partitioned-undirected-relationship-type-scan)
  - Directed Union Relationship Types Scan (id: query-plan-directed-union-relationship-types-scan)
  - Partitioned Directed Union Relationship Types Scan (id: query-plan-partitioned-directed-union-relationship-types-scan)
  - Undirected Union Relationship Types Scan (id: query-plan-undirected-union-relationship-types-scan)
  - Partitioned Undirected Union Relationship Types Scan (id: query-plan-partitioned-undirected-union-relationship-types-scan)
  - Directed Relationship Index Scan (id: query-plan-directed-relationship-index-scan)
  - Partitioned Directed Relationship Index Scan (id: query-plan-partitioned-directed-relationship-index-scan)
  - Undirected Relationship Index Scan (id: query-plan-undirected-relationship-index-scan)
  - Partitioned Undirected Relationship Index Scan (id: query-plan-partitioned-undirected-relationship-index-scan)
  - Directed Relationship Index Contains Scan (id: query-plan-directed-relationship-index-contains-scan)
  - Undirected Relationship Index Contains Scan (id: query-plan-undirected-relationship-index-contains-scan)
  - Directed Relationship Index Ends With Scan (id: query-plan-directed-relationship-index-ends-with-scan)
  - Undirected Relationship Index Ends With Scan (id: query-plan-undirected-relationship-index-ends-with-scan)
  - Directed Relationship Index Seek (id: query-plan-directed-relationship-index-seek)
  - Partitioned Directed Relationship Index Seek (id: query-plan-partitioned-directed-relationship-index-seek)
  - Undirected Relationship Index Seek (id: query-plan-undirected-relationship-index-seek)
  - Partitioned Undirected Relationship Index Seek (id: query-plan-partitioned-undirected-relationship-index-seek)
  - Directed Relationship By Element Id Seek (id: query-plan-directed-relationship-by-element-id-seek)
  - Directed Relationship By Id Seek (id: query-plan-directed-relationship-by-id-seek)
  - Undirected Relationship By Element Id Seek (id: query-plan-undirected-relationship-by-element-id-seek)
  - Undirected Relationship By Id Seek (id: query-plan-undirected-relationship-by-id-seek)
  - Directed Relationship Index Seek By Range (id: query-plan-directed-relationship-index-seek-by-range)
  - Partitioned Directed Relationship Index Seek By Range (id: query-plan-partitioned-directed-relationship-index-seek-by-range)
  - Undirected Relationship Index Seek By Range (id: query-plan-undirected-relationship-index-seek-by-range)
  - Partitioned Undirected Relationship Index Seek By Range (id: query-plan-partitioned-undirected-relationship-index-seek-by-range)
  - Dynamic Label Node LookupIntroduced in 2025.08 (id: query-plan-dynamic-label-node-lookup)
  - Dynamic Directed Relationship Type LookupIntroduced in 2025.08 (id: query-plan-dynamic-directed-relationship-type-lookup)
  - Dynamic Undirected Relationship Type LookupIntroduced in 2025.08 (id: query-plan-dynamic-undirected-relationship-type-lookup)

Nested loops and join operators (nested-loops-join-operators): 14 个操作符
----------------------------------------
  - Apply (id: query-plan-apply)
  - Semi Apply (id: query-plan-semi-apply)
  - Anti Semi Apply (id: query-plan-anti-semi-apply)
  - Let Semi Apply (id: query-plan-let-semi-apply)
  - Let Anti Semi Apply (id: query-plan-let-anti-semi-apply)
  - Select Or Semi Apply (id: query-plan-select-or-semi-apply)
  - Select Or Anti Semi Apply (id: query-plan-select-or-anti-semi-apply)
  - Let Select Or Semi Apply (id: query-plan-let-select-or-semi-apply)
  - Let Select Or Anti Semi Apply (id: query-plan-let-select-or-anti-semi-apply)
  - Roll Up Apply (id: query-plan-roll-up-apply)
  - TransactionApply (id: query-plan-transaction-apply)
  - Argument (id: query-plan-argument)
  - Argument Tracker (id: query-plan-argument-tracker)
  - Cartesian Product (id: query-plan-cartesian-product)

Schema and system operators (schema-system-operators): 13 个操作符
----------------------------------------
  - Create Constraint (id: query-plan-create-constraint)
  - Do Nothing If Exists (constraint) (id: query-plan-do-nothing-if-exists-constraint)
  - Drop Constraint (id: query-plan-drop-constraint)
  - Show Constraints (id: query-plan-show-constraints)
  - Create Index (id: query-plan-create-index)
  - Do Nothing If Exists (index) (id: query-plan-do-nothing-if-exists-index)
  - Drop Index (id: query-plan-drop-index)
  - Show Indexes (id: query-plan-show-indexes)
  - Show Functions (id: query-plan-show-functions)
  - Show Procedures (id: query-plan-show-procedures)
  - Show Settings (id: query-plan-show-settings)
  - Show Transactions (id: query-plan-show-transactions)
  - Terminate Transactions (id: query-plan-terminate-transactions)

Sort and limit operators (sort-limit-operators): 7 个操作符
----------------------------------------
  - Sort (id: query-plan-sort)
  - Partial Sort (id: query-plan-partial-sort)
  - Top (id: query-plan-top)
  - Partial Top (id: query-plan-partial-top)
  - Limit (id: query-plan-limit)
  - Exhaustive Limit (id: query-plan-exhaustive-limit)
  - Skip (id: query-plan-skip)

Traversal operators (traversal-operators): 18 个操作符
----------------------------------------
  - Anti (id: query-plan-anti)
  - Optional (id: query-plan-optional)
  - Expand All (id: query-plan-expand-all)
  - Expand Into (id: query-plan-expand-into)
  - Optional Expand All (id: query-plan-optional-expand-all)
  - Optional Expand Into (id: query-plan-optional-expand-into)
  - VarLength Expand All (id: query-plan-varlength-expand-all)
  - VarLength Expand Into (id: query-plan-varlength-expand-into)
  - VarLength Expand Pruning (id: query-plan-varlength-expand-pruning)
  - Breadth First VarLength Expand Pruning (id: query-plan-breadth-first-varlength-expand-pruning-bfs-all)
  - Repeat (id: query-plan-repeat)
  - Nullify Metadata (id: query-plan-nullify-metadata)
  - Shortest path (id: query-plan-shortest-path)
  - StatefulShortestPath(Into) (id: query-plan-stateful-shortest-path-into)
  - StatefulShortestPath(All) (id: query-plan-stateful-shortest-path-all)
  - Triadic Selection (id: query-plan-triadic-selection)
  - Triadic Build (id: query-plan-triadic-build)
  - Triadic Filter (id: query-plan-triadic-filter)

Union operators (union-operators): 1 个操作符
----------------------------------------
  - Union (id: query-plan-union)

============================================================
总计: 152 个操作符
